1 1 S 0 0 0 0 0 0 0 0 N
1 0 1 1 1 0 0 0 0 0 0 N
1 1 1 0 1 0 0 0 0 0 0 N
1 1 1 1 1 0 0 0 0 0 0 N
1 0 E 0 0 0 0 0 0 0 0 N
1 1 1 0 0 0 0 0 0 0 0 N
