0 1 1 1 S 1 1 1 1 0 0 N
0 1 0 1 1 1 1 0 1 0 0 N
0 1 1 1 1 0 1 0 1 0 0 N
0 1 1 0 1 0 1 1 1 0 0 N
0 1 1 0 1 1 1 1 1 0 0 N
E 1 1 1 1 1 1 1 1 0 0 N
